NO  ./path_to_the_north_texture
SO ./path_to_the_south_texture
WE ./path_to_the_west_texture
EA ./path_to_the_ea
C 160,248,255
F 0,128,0

11111111111111111111111
11000000111111111111111
11000000000001111111111
1100000000000111111111
11000000000000111111111
1100000000000111111111
11000000000001111111111
1100000000000111111111
11000000000000111111111
1100000000000111111111
11000000000001111111111
1100000000000111111111
11000000000000111111111
1100000000000111111111
11000000000001111111111
1100000000000111111111
11000000000000111111111
11000000N0000111111111
11000000000001111111111
1100000000000111111111
11000000000000111111111
1100000000000111111111
11111111111111111111111