SO ./path_to_the_south_texture
WE ./path_to_the_west_texture
NO  ./path_to_the_north_texture
EA ./path_to_the_east_texture
F 0,20,109
C 254,37,0

11111111111      1111
1111N01111      11111
11111111        11111
11111111        11111
11111111        11111