NO ./path_to_the_north_texture
SO ./path_to_the_south_texture
WE ./path_to_the_west_texture
EA ./path_to_the_ea
C 160,248,255
F 0,128,0

1111111111111111111111111111111111111111111111
110N000011111111111110111111111111111111111111
1100000000000000000000000000000000000000000111
1100000000000000000000000000000000000000000111
1100000000000000000000000000000000000000000111
1100000000000000000000000000000000000000000111
1100000000000000000000000000000000000000000111
1100000000000000000000000000000000000000000111
1100000000000000000000000000000000000000000111
110000000000001010000000000000000011111111111111111111
1100000000000000000011111000000000000000000111
1111111111111111111111111111111111111111111111