SO ./path_to_the_south_texture
WE ./path_to_the_west_texture
NO  ./path_to_the_north_texture
EA ./path_to_the_east_texture
F 0,20,109
C 254,37,0

111111111111111111111
1100N0001111111111111
110000111111111111111
110000110000000000001
111111111111111111111