SO ./path_to_the_south_texture
WE ./path_to_the_west_texture
NO  ./path_to_the_north_texture
EA ./path_to_the_ea//31 str
C 160,248,255
F 0,128,0

11111111111111111111111
1100N000111111111111111
11000000000001111111111
1100000000000111111111
11000000000000111111111
1100000000000111111111
11000000000001111111111
1100000000000111111111
11000000000000111111111
1100000000000111111111
11000000000001111111111
1100000000000111111111
11000000000000111111111
1100000000000111111111
11000000000001111111111
1100000000000111111111
11000000000000111111111
1100000000000111111111
11000000000001111111111
1100000000000111111111
11000000000000111111111
1100000000000111111111
11111111111111111111111