SO ./path_to_the_south_texture
WE ./path_to_the_west_texture
NO  ./path_to_the_north_texture
EA ./path_to_the_east_texture
F 0,20,109
C 254,37,0

11111111111111111111111
1100N000111111111111111
11000000000000000000111d
11000000000000000000111
11000000000000000000111
11000000000000000000111
11000000000000000000111
11000000000000000000111
11000000000000000000111
11000000000000000000111
11000000000000000000111
11000000000000000000111
11000000000000000000111
11000000000000000000111
11000000010000000000111
11000000011000000000111
11000000000000000000111
11000000000000000000111
11000000000000000000111
11000000000000000000111
11000000000000000000111
11000000000000000000111
11000000000000000000111
11000000000000000000111
11111111111111111111111