SO  ./path_to_the_south_texture
WE ./path_to_the_west_texture
NO  ./path_to_the_north_texture
EA ./path_to_the_east_texture
C 160,248,255
F 0,128,0

11111111111111111111111
110N0000111111111111101
11000000000000000000001
11000000000001111111111
11000000000000111111111
11000000000000000000111
11000000000000000000111
11000000000000000000111
11000000000000000000111
11000000000000101000111
11000000000000000000111
11111111111111111111111