F 0,0,128
SO walls/pone.png
WE walls/pthree.png
EA walls/pfour.png
C 112,248,255
NO walls/ptwo.png

1111111111111111111
1111111111111111111
1100000000N000000011
1100000000000000011
1100000000000000011
1100000000000000011
1100000000000000011
1100000000000000011
111111111111111111