SO  ./path_to_the_south_texture
WE ./path_to_the_west_texture
NO  ./path_to_the_north_texture
EA ./path_to_the_east_texture
C 160,248,255
F 0,128,0

     

1111111111111111111111111111111
110N000011111111111111111111111
1100000000000111111111111111111
11000000000001
1100000000000011111111111111111
1100000000000000000011111111111
1100000000000000000011111111111
1100000000000000000011111111111
1100000000000000000011111111111
1100000000000010100011111111111
1100000000000000000011111111111
1100000000000011100011111111111
1100000000000010100011111111111
1100000000000010100011111111111
1100000000000010100011111111111
1100000001001000100011111111111
1100000001100111100011111111111
1100000000000000000011111111111
1100000000000000000011111111111
1100000000000000000011111111111
1100000000000000000011111111111
1000000000000000000000111111111
1100000000000000000011111111111
1100000000000000000011111111111
1100000000000000000011111111111
1000000000000000000000111111111
1100000000000000000011111111111
1100000000000000000011111111111
1100000000000000000011111111111
1000000000000000000000111111111
1100000000000000000011111111111
1100000000000000000011111111111
1100000000000000000011111111111
1000000000000000000000111111111
1100000000000000000011111111111
1100000000000000000011111111111
1100000000000000000011111111111
1000000000000000000000111111111
1100000000000000000011111111111
1100000000000000000011111111111
1100000000000000000011111111111
1000000000000000000000111111111
1100000000000000000011111111111
1100000000000000000011111111111
1100000000000000000011111111111
1000000000000000000000111111111
1111111111111111111111111111111