SO  walls/l7it.png
WE walls/path_to_the_west_texture
NO  walls/path_to_the_north_texture
EA walls/path_to_the_east_texture
C 160,248,255
F 0,128,0

     

11111111111111111111111
11000000111111111111111
11000000000001111111111
11000000000001
11000000000000111111111
11000000000000000000111
11000000000000000000111
11000000000000000000111
11000000000000000000111
110000000N0000101000111
11000000000000000000111
11000000000000111000111
11000000000000101000111
11000000000000101000111
11000000000000101000111
11000000010010001000111
11000000011001111000111
11000000000000000000111
11000000000000000000111
11000000000000000000111
11000000000000000000111
10000000000000000000001
11111111111111111111111