NO walls/ptwo.png
SO walls/pone.png
WE walls/pthree.png
EA walls/pfour.png
F 0,128,0
C 112,248,255

1111111111111111111111111111111111111111111111  
1100000000000000000000000000000000000000000111
1100000000000000000000N00000000000000000000111
1100000000000000000000000000000000000000000111
1100000000000000010000000000000000000000000111
1100000000000010100000000000000000111111111111
1100000000000000010011111000000000000000000111
1111111111111111111111111111111111111111111111
1111111111111111111111111111111111111111111111