NO walls/ptwo.png
SO walls/pone.png
WE walls/pthree.png
EA walls/pfour.png
C 160,248,255
F 0,128,0

1111111111111111111111111111111111111111111111
1100000011111111111110111111111111111111111111
1100000000000000000000000000000000000000000111
1100000000000000000000000000000000000000000111
1100000000000000000000000000000000000000000111
1100000000000000000000E00000000000000000000111
1100000000000000000000000000000000000000000111
1100000000000000000000000000000000000000000111
1100000000000000000000000000000000000000000111
1100000000000010100000000000000000111111111111
1100000000000000000011111000000000000000000111
1111111111111111111111111111111111111111111111